,검색일자,국가,대륙,모바일검색량,PC검색량,총검색량
0,2019-07,대만,아시아,190893,32201,223094
1,2019-07,라오스,아시아,3737,174,3911
2,2019-07,러시아,아시아,143038,19812,162850
3,2019-07,몽골,아시아,54233,12197,66430
4,2019-07,미국,오세아니아,38362,15141,53503
5,2019-07,베트남,아시아,125437,39347,164784
6,2019-07,스위스,유럽,7331,959,8290
7,2019-07,싱가포르,아시아,138178,36723,174901
8,2019-07,인도네시아,아시아,13128,1184,14312
9,2019-07,일본,아시아,488805,143337,632142
10,2019-07,조지아,유럽,17158,912,18070
11,2019-07,중국,아시아,122148,30192,152340
12,2019-07,태국,아시아,75661,14040,89701
13,2019-07,필리핀,아시아,4157,200,4357
14,2019-08,대만,아시아,189568,30147,219715
15,2019-08,러시아,아시아,115806,14836,130642
16,2019-08,러시아,유럽,23011,3722,26733
17,2019-08,몽골,아시아,46369,9030,55399
18,2019-08,미국,아메리카,5363,350,5713
19,2019-08,미국,오세아니아,43054,15302,58356
20,2019-08,베트남,아시아,138948,40354,179302
21,2019-08,스페인,유럽,6954,1058,8012
22,2019-08,싱가포르,아시아,104487,29625,134112
23,2019-08,인도네시아,아시아,28746,3333,32079
24,2019-08,일본,아시아,186361,60518,246879
25,2019-08,조지아,유럽,11975,1457,13432
26,2019-08,중국,아시아,104866,25137,130003
27,2019-08,태국,아시아,80361,14009,94370
28,2019-09,대만,아시아,182522,26452,208974
29,2019-09,라오스,아시아,1533,214,1747
30,2019-09,러시아,아시아,81633,13006,94639
31,2019-09,미국,오세아니아,36528,12329,48857
32,2019-09,베트남,아시아,121759,29335,151094
33,2019-09,스페인,유럽,13785,1747,15532
34,2019-09,싱가포르,아시아,84589,22988,107577
35,2019-09,인도네시아,아시아,37768,3829,41597
36,2019-09,일본,아시아,95799,30272,126071
37,2019-09,조지아,유럽,27750,2569,30319
38,2019-09,중국,아시아,64640,16198,80838
39,2019-09,태국,아시아,74645,12209,86854
40,2019-09,터키,유럽,23469,4195,27664
41,2019-09,피지,오세아니아,268543,42786,311329
42,2019-10,대만,아시아,218430,28726,247156
43,2019-10,러시아,아시아,80580,11418,91998
44,2019-10,미국,오세아니아,58566,16422,74988
45,2019-10,베트남,아시아,167543,39482,207025
46,2019-10,스페인,유럽,59338,8088,67426
47,2019-10,싱가포르,아시아,95392,23304,118696
48,2019-10,이탈리아,유럽,4630,513,5143
49,2019-10,인도네시아,아시아,14027,1415,15442
50,2019-10,일본,아시아,86731,24639,111370
51,2019-10,중국,아시아,62352,14844,77196
52,2019-10,태국,아시아,78232,12990,91222
53,2019-10,터키,유럽,25354,3954,29308
54,2019-10,피지,오세아니아,12527,309,12836
55,2019-11,대만,아시아,262629,31202,293831
56,2019-11,라오스,아시아,12249,1430,13679
57,2019-11,러시아,아시아,85133,9462,94595
58,2019-11,미국,아메리카,2799,318,3117
59,2019-11,미국,오세아니아,72820,17523,90343
60,2019-11,베트남,아시아,225547,48134,273681
61,2019-11,스위스,유럽,1683,508,2191
62,2019-11,스페인,유럽,50069,6743,56812
63,2019-11,싱가포르,아시아,102854,23387,126241
64,2019-11,인도네시아,아시아,16148,1742,17890
65,2019-11,일본,아시아,99404,25787,125191
66,2019-11,조지아,유럽,5077,306,5383
67,2019-11,중국,아시아,67856,14749,82605
68,2019-11,태국,아시아,85844,13840,99684
69,2019-11,포르투갈,유럽,1431,118,1549
70,2019-12,뉴질랜드,오세아니아,10636,902,11538
71,2019-12,대만,아시아,303447,35287,338734
72,2019-12,러시아,아시아,58317,6135,64452
73,2019-12,몰타,유럽,2632,196,2828
74,2019-12,미국,아메리카,1730,184,1914
75,2019-12,미국,오세아니아,86806,19726,106532
76,2019-12,베트남,아시아,242968,57549,300517
77,2019-12,스위스,유럽,2848,344,3192
78,2019-12,스페인,유럽,12494,1441,13935
79,2019-12,싱가포르,아시아,83762,24035,107797
80,2019-12,아랍에미리트,아시아,15984,705,16689
81,2019-12,일본,아시아,186138,40231,226369
82,2019-12,중국,아시아,61462,12635,74097
83,2019-12,태국,아시아,69076,14522,83598
84,2019-12,포르투갈,유럽,1769,131,1900
85,2020-01,대만,아시아,299135,32401,331536
86,2020-01,라오스,아시아,12912,1047,13959
87,2020-01,러시아,아시아,110241,12877,123118
88,2020-01,미국,오세아니아,91900,20286,112186
89,2020-01,베트남,아시아,245571,46582,292153
90,2020-01,스위스,유럽,15526,1162,16688
91,2020-01,스페인,유럽,58433,6178,64611
92,2020-01,싱가포르,아시아,105496,24144,129640
93,2020-01,아랍에미리트,아시아,10267,1396,11663
94,2020-01,일본,아시아,212096,41962,254058
95,2020-01,중국,아시아,43733,6543,50276
96,2020-01,태국,아시아,105494,16289,121783
97,2020-01,필리핀,아시아,4015,550,4565
98,2020-02,뉴질랜드,오세아니아,10069,1170,11239
99,2020-02,대만,아시아,59501,10091,69592
100,2020-02,러시아,아시아,20129,5291,25420
101,2020-02,몰타,유럽,1232,106,1338
102,2020-02,미국,아메리카,3592,982,4574
103,2020-02,미국,오세아니아,61630,12766,74396
104,2020-02,베트남,아시아,70322,14079,84401
105,2020-02,스위스,유럽,92425,11195,103620
106,2020-02,스페인,유럽,51229,9022,60251
107,2020-02,싱가포르,아시아,18391,3669,22060
108,2020-02,아르헨티나,아메리카,17346,579,17925
109,2020-02,이스라엘,아시아,1896,123,2019
110,2020-02,이탈리아,유럽,6686,1243,7929
111,2020-02,인도네시아,아시아,27333,5370,32703
112,2020-02,일본,아시아,68513,16184,84697
113,2020-02,중국,아시아,5657,757,6414
114,2020-02,태국,아시아,31226,7008,38234
115,2020-02,터키,유럽,9056,2001,11057
116,2020-02,팔라우,오세아니아,30194,2279,32473
117,2020-03,뉴질랜드,오세아니아,1465,214,1679
118,2020-03,대만,아시아,12627,3210,15837
119,2020-03,라오스,아시아,1028,123,1151
120,2020-03,러시아,아시아,2150,249,2399
121,2020-03,모로코,아프리카,585,47,632
122,2020-03,몰타,유럽,7320,315,7635
123,2020-03,몽골,아시아,2802,638,3440
124,2020-03,미국,아메리카,18712,4253,22965
125,2020-03,미국,오세아니아,23787,5862,29649
126,2020-03,베트남,아시아,10648,2630,13278
127,2020-03,벨기에,유럽,638,27,665
128,2020-03,스위스,유럽,28732,4334,33066
129,2020-03,스페인,유럽,15076,2847,17923
130,2020-03,아랍에미리트,아시아,1618,98,1716
131,2020-03,아르헨티나,아메리카,24259,1331,25590
132,2020-03,이집트,아프리카,1643,361,2004
133,2020-03,이탈리아,유럽,12834,1723,14557
134,2020-03,인도네시아,아시아,22220,4508,26728
135,2020-03,일본,아시아,32509,8191,40700
136,2020-03,중국,아시아,285,53,338
137,2020-03,캐나다,아메리카,1247,127,1374
138,2020-03,태국,아시아,6440,1956,8396
139,2020-03,터키,유럽,2208,296,2504
140,2020-04,대만,아시아,13670,3563,17233
141,2020-04,라오스,아시아,5856,792,6648
142,2020-04,러시아,아시아,646,118,764
143,2020-04,몽골,아시아,3068,750,3818
144,2020-04,미국,아메리카,11597,2713,14310
145,2020-04,미국,오세아니아,8968,2906,11874
146,2020-04,베트남,아시아,12587,2993,15580
147,2020-04,스위스,유럽,13294,3286,16580
148,2020-04,스페인,유럽,631,91,722
149,2020-04,아르헨티나,아메리카,4656,256,4912
150,2020-04,인도네시아,아시아,12916,2698,15614
151,2020-04,일본,아시아,22039,6209,28248
152,2020-04,조지아,유럽,829,43,872
153,2020-04,중국,아시아,2741,682,3423
154,2020-04,태국,아시아,8992,2752,11744
155,2020-04,피지,오세아니아,623,64,687
156,2020-05,대만,아시아,15799,4170,19969
157,2020-05,라오스,아시아,1170,195,1365
158,2020-05,러시아,아시아,531,26,557
159,2020-05,러시아,유럽,365,30,395
160,2020-05,몽골,아시아,2095,365,2460
161,2020-05,미국,아메리카,13137,3117,16254
162,2020-05,미국,오세아니아,10112,2938,13050
163,2020-05,베트남,아시아,20539,5061,25600
164,2020-05,스위스,유럽,11889,3361,15250
165,2020-05,스페인,유럽,316,26,342
166,2020-05,아랍에미리트,아시아,1504,173,1677
167,2020-05,이탈리아,유럽,4281,1301,5582
168,2020-05,인도네시아,아시아,19631,3263,22894
169,2020-05,일본,아시아,28685,7634,36319
170,2020-05,중국,아시아,905,189,1094
171,2020-05,태국,아시아,34036,5316,39352
172,2020-05,팔라우,오세아니아,520,25,545
173,2020-06,그리스,유럽,642,166,808
174,2020-06,뉴질랜드,오세아니아,3782,1001,4783
175,2020-06,대만,아시아,17151,4510,21661
176,2020-06,몽골,아시아,279,41,320
177,2020-06,미국,아메리카,16611,4261,20872
178,2020-06,미국,오세아니아,14755,4161,18916
179,2020-06,베트남,아시아,17297,4788,22085
180,2020-06,스위스,유럽,11066,3362,14428
181,2020-06,스페인,유럽,220,55,275
182,2020-06,이탈리아,유럽,2006,620,2626
183,2020-06,인도,아시아,202,370,572
184,2020-06,인도네시아,아시아,17362,3851,21213
185,2020-06,일본,아시아,33420,9086,42506
186,2020-06,중국,아시아,1604,537,2141
187,2020-06,탄자니아,아프리카,646,20,666
188,2020-06,태국,아시아,19008,4817,23825
189,2020-06,터키,유럽,1271,115,1386
190,2020-06,프랑스,유럽,400,79,479
191,2020-07,그리스,유럽,269,32,301
192,2020-07,뉴질랜드,오세아니아,407,45,452
193,2020-07,대만,아시아,20196,4893,25089
194,2020-07,라오스,아시아,1678,137,1815
195,2020-07,러시아,아시아,294,38,332
196,2020-07,몽골,아시아,2178,315,2493
197,2020-07,미국,아메리카,16954,3748,20702
198,2020-07,미국,오세아니아,10483,3367,13850
199,2020-07,베트남,아시아,17948,3900,21848
200,2020-07,스위스,유럽,13161,3085,16246
201,2020-07,이탈리아,유럽,1685,402,2087
202,2020-07,인도네시아,아시아,10856,2308,13164
203,2020-07,일본,아시아,36030,9303,45333
204,2020-07,조지아,유럽,546,24,570
205,2020-07,중국,아시아,5995,1762,7757
206,2020-07,체코,유럽,267,199,466
207,2020-07,태국,아시아,13289,3653,16942
208,2020-07,터키,유럽,360,40,400
209,2020-07,팔라우,오세아니아,2338,591,2929
210,2020-07,프랑스,유럽,328,59,387
211,2020-08,대만,아시아,11783,6794,18577
212,2020-08,러시아,아시아,368,35,403
213,2020-08,러시아,유럽,37,198,235
214,2020-08,몽골,아시아,273,584,857
215,2020-08,미국,아메리카,15890,9261,25151
216,2020-08,미국,오세아니아,6815,3445,10260
217,2020-08,베트남,아시아,10359,5863,16222
218,2020-08,스위스,유럽,7769,5890,13659
219,2020-08,오스트리아,유럽,22,403,425
220,2020-08,인도네시아,아시아,7489,5364,12853
221,2020-08,일본,아시아,21001,12455,33456
222,2020-08,조지아,유럽,690,402,1092
223,2020-08,중국,아시아,3488,1771,5259
224,2020-08,태국,아시아,7553,4346,11899
225,2020-08,터키,유럽,356,558,914
226,2020-08,팔라우,오세아니아,4677,2497,7174
227,2020-08,프랑스,오세아니아,315,16,331
228,2020-09,대만,아시아,3425,13578,17003
229,2020-09,러시아,아시아,31,229,260
230,2020-09,러시아,유럽,25,255,280
231,2020-09,몽골,아시아,54,264,318
232,2020-09,미국,아메리카,3908,18987,22895
233,2020-09,미국,오세아니아,1071,4000,5071
234,2020-09,베트남,아시아,2788,12672,15460
235,2020-09,스위스,유럽,2974,12250,15224
236,2020-09,스페인,유럽,352,1492,1844
237,2020-09,아르헨티나,아메리카,9,283,292
238,2020-09,영국여행,유럽,136,870,1006
239,2020-09,이탈리아,유럽,40,239,279
240,2020-09,인도,아시아,229,1016,1245
241,2020-09,인도네시아,아시아,882,3410,4292
242,2020-09,일본,아시아,7553,28393,35946
243,2020-09,조지아,유럽,102,113,215
244,2020-09,중국,아시아,2155,9044,11199
245,2020-09,캐나다,아메리카,37,219,256
246,2020-09,태국,아시아,2771,9247,12018
247,2020-09,터키,유럽,126,787,913
248,2020-09,팔라우,오세아니아,11,538,549
249,2020-09,프랑스,유럽,170,821,991
250,2020-10,뉴질랜드,오세아니아,23,254,277
251,2020-10,대만,아시아,3365,14367,17732
252,2020-10,몽골,아시아,174,821,995
253,2020-10,미국,아메리카,4170,20701,24871
254,2020-10,미국,오세아니아,1128,4371,5499
255,2020-10,베트남,아시아,3060,13174,16234
256,2020-10,스위스,유럽,2431,10421,12852
257,2020-10,스페인,유럽,266,1319,1585
258,2020-10,이탈리아,유럽,51,206,257
259,2020-10,인도,아시아,35,526,561
260,2020-10,인도네시아,아시아,605,4051,4656
261,2020-10,일본,아시아,10187,39760,49947
262,2020-10,중국,아시아,2354,9129,11483
263,2020-10,캐나다,아메리카,207,1220,1427
264,2020-10,태국,아시아,2818,9576,12394
265,2020-10,터키,유럽,43,269,312
266,2020-10,팔라우,오세아니아,14,504,518
267,2020-10,필리핀,아시아,63,192,255
268,2020-10,호주,오세아니아,347,735,1082
269,2020-11,그리스,유럽,33,355,388
270,2020-11,뉴질랜드,오세아니아,151,820,971
271,2020-11,대만,아시아,2811,11466,14277
272,2020-11,라오스,아시아,51,499,550
273,2020-11,러시아,아시아,106,1137,1243
274,2020-11,러시아,유럽,46,134,180
275,2020-11,몰타,유럽,290,7621,7911
276,2020-11,몽골,아시아,91,141,232
277,2020-11,미국,아메리카,4153,22149,26302
278,2020-11,미국,오세아니아,133,624,757
279,2020-11,베트남,아시아,2780,11658,14438
280,2020-11,스위스,유럽,2308,8533,10841
281,2020-11,아랍에미리트,아시아,53,416,469
282,2020-11,인도,아시아,125,520,645
283,2020-11,인도네시아,아시아,328,1770,2098
284,2020-11,일본,아시아,9129,33490,42619
285,2020-11,중국,아시아,2033,9010,11043
286,2020-11,캐나다,아메리카,837,4835,5672
287,2020-11,태국,아시아,2295,8195,10490
288,2020-11,터키,유럽,251,1197,1448
289,2020-11,팔라우,오세아니아,14,567,581
290,2020-11,프랑스,유럽,40,169,209
291,2020-12,뉴질랜드,오세아니아,89,543,632
292,2020-12,대만,아시아,2329,9823,12152
293,2020-12,러시아,아시아,53,601,654
294,2020-12,러시아,유럽,96,443,539
295,2020-12,모로코,아프리카,34,818,852
296,2020-12,몰타,유럽,13,230,243
297,2020-12,미국,아메리카,3313,14689,18002
298,2020-12,미국,오세아니아,438,1432,1870
299,2020-12,베트남,아시아,2091,8127,10218
300,2020-12,볼리비아,아프리카,8,225,233
301,2020-12,스위스,유럽,2199,9462,11661
302,2020-12,오스트리아,유럽,16,199,215
303,2020-12,이집트,아프리카,129,2001,2130
304,2020-12,이탈리아,유럽,33,221,254
305,2020-12,인도,아시아,67,341,408
306,2020-12,인도네시아,아시아,100,317,417
307,2020-12,일본,아시아,6295,20490,26785
308,2020-12,중국,아시아,1297,5200,6497
309,2020-12,캐나다,아메리카,406,1931,2337
310,2020-12,태국,아시아,2023,7120,9143
311,2020-12,터키,유럽,626,3704,4330
312,2020-12,프랑스,유럽,63,174,237
313,2021-01,뉴질랜드,오세아니아,287,1797,2084
314,2021-01,대만,아시아,2394,10002,12396
315,2021-01,라오스,아시아,78,795,873
316,2021-01,말레이시아,아시아,10,272,282
317,2021-01,몽골,아시아,319,1864,2183
318,2021-01,미국,아메리카,2957,16114,19071
319,2021-01,미국,오세아니아,847,3002,3849
320,2021-01,베트남,아시아,2565,13502,16067
321,2021-01,스위스,유럽,1764,9983,11747
322,2021-01,아랍에미리트,아시아,485,2463,2948
323,2021-01,인도네시아,아시아,478,2855,3333
324,2021-01,일본,아시아,6014,21522,27536
325,2021-01,조지아,유럽,33,933,966
326,2021-01,중국,아시아,616,3158,3774
327,2021-01,캐나다,아메리카,175,1625,1800
328,2021-01,콜롬비아,아메리카,15,584,599
329,2021-01,태국,아시아,1837,7592,9429
330,2021-01,터키,유럽,159,1261,1420
331,2021-01,팔라우,오세아니아,175,1924,2099
332,2021-02,뉴질랜드,오세아니아,25,166,191
333,2021-02,대만,아시아,2114,8865,10979
334,2021-02,러시아,아시아,26,458,484
335,2021-02,러시아,유럽,24,188,212
336,2021-02,몰타,유럽,23,842,865
337,2021-02,몽골,아시아,29,409,438
338,2021-02,미국,아메리카,3238,17535,20773
339,2021-02,미국,오세아니아,900,2495,3395
340,2021-02,베트남,아시아,2229,11400,13629
341,2021-02,스위스,유럽,1338,7868,9206
342,2021-02,스페인,유럽,131,556,687
343,2021-02,아랍에미리트,아시아,564,3321,3885
344,2021-02,영국,유럽,6,17,23
345,2021-02,영국여행,유럽,71,266,337
346,2021-02,이집트,아프리카,374,1578,1952
347,2021-02,이탈리아,유럽,138,1685,1823
348,2021-02,인도네시아,아시아,202,681,883
349,2021-02,일본,아시아,5808,21286,27094
350,2021-02,조지아,유럽,262,2971,3233
351,2021-02,중국,아시아,284,1404,1688
352,2021-02,캐나다,아메리카,48,470,518
353,2021-02,케냐,아프리카,127,370,497
354,2021-02,태국,아시아,1891,6669,8560
355,2021-02,터키,유럽,322,2298,2620
356,2021-02,팔라우,오세아니아,38,493,531
357,2021-02,프랑스,유럽,28,170,198
358,2021-02,필리핀,아시아,14,311,325
359,2021-03,대만,아시아,3050,12279,15329
360,2021-03,라오스,아시아,39,216,255
361,2021-03,러시아,아시아,106,1075,1181
362,2021-03,몽골,아시아,65,496,561
363,2021-03,미국,아메리카,4097,18712,22809
364,2021-03,미국,오세아니아,1159,3920,5079
365,2021-03,베트남,아시아,3311,14966,18277
366,2021-03,스위스,유럽,2151,8704,10855
367,2021-03,스페인,유럽,432,1958,2390
368,2021-03,싱가포르,아시아,97,839,936
369,2021-03,아랍에미리트,아시아,71,531,602
370,2021-03,이집트,아프리카,84,245,329
371,2021-03,인도네시아,아시아,43,171,214
372,2021-03,일본,아시아,7709,26933,34642
373,2021-03,조지아,유럽,13,1004,1017
374,2021-03,중국,아시아,1234,5350,6584
375,2021-03,캐나다,아메리카,52,182,234
376,2021-03,태국,아시아,3082,10527,13609
377,2021-03,터키,유럽,764,5329,6093
378,2021-03,팔라우,오세아니아,132,2055,2187
379,2021-04,그리스,유럽,321,1049,1370
380,2021-04,대만,아시아,2737,10195,12932
381,2021-04,몰타,유럽,30,467,497
382,2021-04,미국,아메리카,4852,19702,24554
383,2021-04,미국,오세아니아,1280,4030,5310
384,2021-04,베트남,아시아,3084,13263,16347
385,2021-04,스위스,유럽,1743,5759,7502
386,2021-04,스페인,유럽,386,1450,1836
387,2021-04,싱가포르,아시아,59,145,204
388,2021-04,아랍에미리트,아시아,18,215,233
389,2021-04,영국여행,유럽,80,177,257
390,2021-04,이스라엘,아시아,256,2272,2528
391,2021-04,이탈리아,유럽,480,1566,2046
392,2021-04,인도,아시아,319,1809,2128
393,2021-04,인도네시아,아시아,46,510,556
394,2021-04,일본,아시아,6890,22503,29393
395,2021-04,중국,아시아,1221,4347,5568
396,2021-04,캐나다,아메리카,86,424,510
397,2021-04,쿠바,아메리카,35,1226,1261
398,2021-04,태국,아시아,3058,10347,13405
399,2021-04,터키,유럽,498,2723,3221
400,2021-05,그리스,유럽,72,444,516
401,2021-05,뉴질랜드,오세아니아,53,298,351
402,2021-05,대만,아시아,2619,9391,12010
403,2021-05,러시아,아시아,35,302,337
404,2021-05,몰타,유럽,52,1126,1178
405,2021-05,몽골,아시아,25,274,299
406,2021-05,미국,아메리카,6055,24391,30446
407,2021-05,미국,오세아니아,3073,9904,12977
408,2021-05,베트남,아시아,2722,12166,14888
409,2021-05,스위스,유럽,2256,6451,8707
410,2021-05,스페인,유럽,1117,2799,3916
411,2021-05,싱가포르,아시아,546,2990,3536
412,2021-05,이스라엘,아시아,161,1843,2004
413,2021-05,이탈리아,유럽,66,178,244
414,2021-05,인도,아시아,194,1349,1543
415,2021-05,일본,아시아,7761,25877,33638
416,2021-05,조지아,유럽,34,658,692
417,2021-05,중국,아시아,1119,4154,5273
418,2021-05,캐나다,아메리카,55,289,344
419,2021-05,태국,아시아,2829,10640,13469
420,2021-05,터키,유럽,409,3010,3419
421,2021-05,프랑스,유럽,208,477,685
422,2021-06,대만,아시아,2589,8567,11156
423,2021-06,몰타,유럽,61,864,925
424,2021-06,몽골,아시아,85,1119,1204
425,2021-06,미국,아메리카,7580,28047,35627
426,2021-06,미국,오세아니아,7710,23798,31508
427,2021-06,베트남,아시아,2992,12517,15509
428,2021-06,스위스,유럽,2389,7981,10370
429,2021-06,스페인,유럽,1955,7296,9251
430,2021-06,싱가포르,아시아,2425,11180,13605
431,2021-06,인도,아시아,77,404,481
432,2021-06,인도네시아,아시아,169,1654,1823
433,2021-06,일본,아시아,9272,30463,39735
434,2021-06,조지아,유럽,42,2309,2351
435,2021-06,태국,아시아,4433,16834,21267
436,2021-06,터키,유럽,1172,7124,8296
437,2021-06,프랑스,유럽,1422,4663,6085
438,2021-06,필리핀,아시아,135,610,745
439,2021-07,그리스,유럽,33,597,630
440,2021-07,뉴질랜드,오세아니아,45,202,247
441,2021-07,대만,아시아,1908,8118,10026
442,2021-07,라오스,아시아,59,276,335
443,2021-07,몰타,유럽,32,798,830
444,2021-07,몽골,아시아,113,1109,1222
445,2021-07,미국,아메리카,5806,25056,30862
446,2021-07,미국,오세아니아,5208,18233,23441
447,2021-07,베트남,아시아,1625,7560,9185
448,2021-07,스위스,유럽,1401,4586,5987
449,2021-07,스페인,유럽,260,1068,1328
450,2021-07,에스토니아,유럽,150,3839,3989
451,2021-07,이스라엘,아시아,37,1628,1665
452,2021-07,이탈리아,유럽,49,232,281
453,2021-07,인도네시아,아시아,267,4010,4277
454,2021-07,일본,아시아,6177,23467,29644
455,2021-07,조지아,유럽,192,3712,3904
456,2021-07,중국,아시아,254,768,1022
457,2021-07,체코,유럽,43,622,665
458,2021-07,케냐,아프리카,20,474,494
459,2021-07,쿠바,아메리카,46,488,534
460,2021-07,태국,아시아,2741,10652,13393
461,2021-07,터키,유럽,289,2343,2632
462,2021-07,팔라우,오세아니아,96,6022,6118
463,2021-07,필리핀,아시아,365,1578,1943
464,2021-08,그리스,유럽,178,1645,1823
465,2021-08,대만,아시아,2187,8888,11075
466,2021-08,모로코,아프리카,298,6951,7249
467,2021-08,몽골,아시아,19,266,285
468,2021-08,미국,아메리카,7276,33038,40314
469,2021-08,미국,오세아니아,7209,29738,36947
470,2021-08,베트남,아시아,818,3829,4647
471,2021-08,브라질,아메리카,30,269,299
472,2021-08,스위스,유럽,2248,11388,13636
473,2021-08,스페인,유럽,209,1302,1511
474,2021-08,아랍에미리트,아시아,25,411,436
475,2021-08,이스라엘,아시아,25,442,467
476,2021-08,이탈리아,유럽,136,572,708
477,2021-08,인도네시아,아시아,141,1244,1385
478,2021-08,일본,아시아,7014,28073,35087
479,2021-08,조지아,유럽,38,306,344
480,2021-08,중국,아시아,178,519,697
481,2021-08,캐나다,아메리카,72,219,291
482,2021-08,케냐,아프리카,26,558,584
483,2021-08,쿠바,아메리카,49,1110,1159
484,2021-08,태국,아시아,2529,10879,13408
485,2021-08,터키,유럽,1163,9238,10401
486,2021-08,프랑스,유럽,194,1340,1534
487,2021-09,대만,아시아,2927,13121,16048
488,2021-09,몰타,유럽,56,3929,3985
489,2021-09,미국,아메리카,8768,43693,52461
490,2021-09,미국,오세아니아,13596,73792,87388
491,2021-09,베트남,아시아,1110,5470,6580
492,2021-09,스위스,유럽,2587,9272,11859
493,2021-09,스페인,유럽,2381,11716,14097
494,2021-09,아랍에미리트,아시아,48,357,405
495,2021-09,오스트리아,유럽,20,859,879
496,2021-09,이탈리아,유럽,628,2438,3066
497,2021-09,인도네시아,아시아,1467,10156,11623
498,2021-09,일본,아시아,10450,44860,55310
499,2021-09,조지아,유럽,28,417,445
500,2021-09,태국,아시아,4397,20433,24830
501,2021-09,터키,유럽,154,1189,1343
502,2021-09,팔라우,오세아니아,31,564,595
503,2021-09,프랑스,유럽,180,689,869
504,2021-10,대만,아시아,1766,9974,11740
505,2021-10,미국,아메리카,11302,57549,68851
506,2021-10,미국,오세아니아,18799,92335,111134
507,2021-10,베트남,아시아,4422,22548,26970
508,2021-10,스위스,유럽,1375,6540,7915
509,2021-10,스페인,유럽,4981,26032,31013
510,2021-10,싱가포르,아시아,8081,47547,55628
511,2021-10,인도네시아,아시아,1675,10348,12023
512,2021-10,일본,아시아,24644,101236,125880
513,2021-10,태국,아시아,11900,58729,70629
514,2021-10,터키,유럽,2521,17288,19809
515,2021-11,대만,아시아,2297,10552,12849
516,2021-11,미국,아메리카,11684,54699,66383
517,2021-11,미국,오세아니아,15391,59552,74943
518,2021-11,베트남,아시아,6999,34920,41919
519,2021-11,스위스,유럽,2838,13460,16298
520,2021-11,스페인,유럽,5423,26237,31660
521,2021-11,싱가포르,아시아,7994,40620,48614
522,2021-11,일본,아시아,34836,132378,167214
523,2021-11,태국,아시아,14257,60687,74944
524,2021-11,터키,유럽,6613,40655,47268
525,2021-11,프랑스,유럽,137,555,692
526,2021-11,호주,오세아니아,217,679,896
527,2021-12,대만,아시아,1345,7086,8431
528,2021-12,러시아,아시아,46,448,494
529,2021-12,미국,아메리카,7341,35131,42472
530,2021-12,미국,오세아니아,3805,13876,17681
531,2021-12,베트남,아시아,4336,21951,26287
532,2021-12,스위스,유럽,1222,7013,8235
533,2021-12,스페인,유럽,1717,9132,10849
534,2021-12,싱가포르,아시아,4667,24485,29152
535,2021-12,아랍에미리트,아시아,169,2714,2883
536,2021-12,일본,아시아,12248,66695,78943
537,2021-12,태국,아시아,6002,28791,34793
538,2021-12,터키,유럽,4911,23109,28020
539,2021-12,프랑스,유럽,758,3694,4452
540,2021-12,호주,오세아니아,269,1236,1505
541,2022-01,대만,아시아,421,1889,2310
542,2022-01,라오스,아시아,65,1089,1154
543,2022-01,미국,아메리카,5120,25861,30981
544,2022-01,미국,오세아니아,6455,28502,34957
545,2022-01,베트남,아시아,3672,20713,24385
546,2022-01,스위스,유럽,1801,12289,14090
547,2022-01,스페인,유럽,446,3921,4367
548,2022-01,싱가포르,아시아,3324,19482,22806
549,2022-01,아랍에미리트,아시아,823,17942,18765
550,2022-01,일본,아시아,11350,66321,77671
551,2022-01,태국,아시아,4574,21718,26292
552,2022-01,터키,유럽,3985,20312,24297
553,2022-01,필리핀,아시아,191,1443,1634
554,2022-02,대만,아시아,629,2789,3418
555,2022-02,라오스,아시아,38,1039,1077
556,2022-02,러시아,유럽,466,2575,3041
557,2022-02,미국,아메리카,4420,23552,27972
558,2022-02,미국,오세아니아,7151,36991,44142
559,2022-02,베트남,아시아,5263,28609,33872
560,2022-02,스위스,유럽,2433,13855,16288
561,2022-02,스페인,유럽,860,5546,6406
562,2022-02,싱가포르,아시아,3769,21333,25102
563,2022-02,아랍에미리트,아시아,286,6396,6682
564,2022-02,이탈리아,유럽,199,2579,2778
565,2022-02,일본,아시아,14224,70366,84590
566,2022-02,조지아,유럽,156,3109,3265
567,2022-02,태국,아시아,5030,25618,30648
568,2022-02,터키,유럽,3286,18629,21915
569,2022-02,팔라우,오세아니아,44,1373,1417
570,2022-02,필리핀,아시아,1329,6173,7502
571,2022-02,호주,오세아니아,163,529,692
572,2022-03,대만,아시아,1352,7016,8368
573,2022-03,미국,아메리카,9679,55621,65300
574,2022-03,미국,오세아니아,18395,89179,107574
575,2022-03,베트남,아시아,12129,65411,77540
576,2022-03,스위스,유럽,3865,19130,22995
577,2022-03,스페인,유럽,949,5603,6552
578,2022-03,싱가포르,아시아,7228,42377,49605
579,2022-03,아랍에미리트,아시아,0,1791,1791
580,2022-03,인도네시아,아시아,5618,28258,33876
581,2022-03,일본,아시아,41041,167809,208850
582,2022-03,태국,아시아,10258,50665,60923
583,2022-03,터키,유럽,6034,33567,39601
584,2022-04,대만,아시아,5662,28677,34339
585,2022-04,미국,아메리카,12441,70478,82919
586,2022-04,미국,오세아니아,21358,86579,107937
587,2022-04,베트남,아시아,17322,86837,104159
588,2022-04,스위스,유럽,5341,30871,36212
589,2022-04,스페인,유럽,1890,13179,15069
590,2022-04,싱가포르,아시아,11017,66263,77280
591,2022-04,인도네시아,아시아,8078,49352,57430
592,2022-04,일본,아시아,68250,274684,342934
593,2022-04,태국,아시아,14905,72164,87069
594,2022-04,터키,유럽,7917,55905,63822
595,2022-05,대만,아시아,11778,58651,70429
596,2022-05,라오스,아시아,148,1927,2075
597,2022-05,몰타,유럽,76,3627,3703
598,2022-05,몽골,아시아,99,1707,1806
599,2022-05,미국,아메리카,11278,66139,77417
600,2022-05,미국,오세아니아,21493,87957,109450
601,2022-05,베트남,아시아,22446,127622,150068
602,2022-05,볼리비아,아프리카,103,6056,6159
603,2022-05,스위스,유럽,4825,24958,29783
604,2022-05,스페인,유럽,604,2591,3195
605,2022-05,싱가포르,아시아,14960,95421,110381
606,2022-05,아랍에미리트,아시아,194,4794,4988
607,2022-05,이탈리아,유럽,360,3267,3627
608,2022-05,인도네시아,아시아,8579,52387,60966
609,2022-05,일본,아시아,135244,598561,733805
610,2022-05,중국,아시아,125,570,695
611,2022-05,태국,아시아,18702,95012,113714
612,2022-05,터키,유럽,10061,77041,87102
613,2022-05,필리핀,아시아,866,4870,5736
614,2022-06,대만,아시아,14976,67960,82936
615,2022-06,몽골,아시아,659,3175,3834
616,2022-06,미국,아메리카,10146,62330,72476
617,2022-06,미국,오세아니아,25904,112103,138007
618,2022-06,베트남,아시아,29987,166448,196435
619,2022-06,스위스,유럽,802,6722,7524
620,2022-06,싱가포르,아시아,19211,116232,135443
621,2022-06,인도네시아,아시아,8188,49062,57250
622,2022-06,일본,아시아,135516,582503,718019
623,2022-06,중국,아시아,379,1325,1704
624,2022-06,태국,아시아,30234,140214,170448
625,2022-06,터키,유럽,9942,71491,81433
626,2022-06,필리핀,아시아,950,5187,6137
627,2022-07,대만,아시아,11639,53562,65201
628,2022-07,몽골,아시아,7180,38832,46012
629,2022-07,미국,오세아니아,22766,99424,122190
630,2022-07,베트남,아시아,37356,188083,225439
631,2022-07,싱가포르,아시아,19032,113950,132982
632,2022-07,인도네시아,아시아,5445,38062,43507
633,2022-07,일본,아시아,85821,392465,478286
634,2022-07,태국,아시아,37911,190860,228771
635,2022-07,터키,유럽,6286,41921,48207
636,2022-08,대만,아시아,7515,33640,41155
637,2022-08,몽골,아시아,4954,26498,31452
638,2022-08,미국,아메리카,773,5919,6692
639,2022-08,미국,오세아니아,20635,85908,106543
640,2022-08,베트남,아시아,30571,162873,193444
641,2022-08,스위스,유럽,9075,91937,101012
642,2022-08,스페인,유럽,153,2276,2429
643,2022-08,싱가포르,아시아,16899,105273,122172
644,2022-08,인도,아시아,1228,4520,5748
645,2022-08,인도네시아,아시아,8536,52787,61323
646,2022-08,일본,아시아,83305,386338,469643
647,2022-08,태국,아시아,39061,200873,239934
648,2022-08,터키,유럽,1293,11663,12956
649,2022-08,필리핀,아시아,91,2207,2298
650,2022-09,대만,아시아,21582,87471,109053
651,2022-09,몽골,아시아,584,6530,7114
652,2022-09,미국,아메리카,663,6785,7448
653,2022-09,미국,오세아니아,19392,82943,102335
654,2022-09,베트남,아시아,17780,101044,118824
655,2022-09,스위스,유럽,3146,26666,29812
656,2022-09,싱가포르,아시아,16560,105139,121699
657,2022-09,이탈리아,유럽,253,2238,2491
658,2022-09,인도네시아,아시아,1123,14166,15289
659,2022-09,일본,아시아,222835,901588,1124423
660,2022-09,태국,아시아,32043,154785,186828
661,2022-09,터키,유럽,2650,21466,24116
662,2022-10,대만,아시아,26001,123170,149171
663,2022-10,미국,오세아니아,17352,88571,105923
664,2022-10,베트남,아시아,17179,121777,138956
665,2022-10,싱가포르,아시아,15773,114622,130395
666,2022-10,인도네시아,아시아,129,1716,1845
667,2022-10,일본,아시아,197354,865900,1063254
668,2022-10,캄보디아,아시아,67,2456,2523
669,2022-10,태국,아시아,24885,146856,171741
670,2022-10,터키,유럽,153,2357,2510
671,2022-10,필리핀,아시아,3203,16571,19774
672,2022-11,대만,아시아,27952,130370,158322
673,2022-11,라오스,아시아,147,3369,3516
674,2022-11,모로코,아프리카,86,3125,3211
675,2022-11,미국,오세아니아,7646,29070,36716
676,2022-11,베트남,아시아,18107,114386,132493
677,2022-11,싱가포르,아시아,16687,111969,128656
678,2022-11,일본,아시아,224970,949885,1174855
679,2022-11,중국,아시아,394,3337,3731
680,2022-11,태국,아시아,19074,112149,131223
681,2022-11,터키,유럽,710,7613,8323
682,2022-11,필리핀,아시아,6148,31125,37273
683,2022-12,대만,아시아,32771,162432,195203
684,2022-12,모로코,아프리카,302,4384,4686
685,2022-12,미국,오세아니아,628,2459,3087
686,2022-12,베트남,아시아,26313,215590,241903
687,2022-12,스위스,유럽,226,4395,4621
688,2022-12,싱가포르,아시아,18695,129285,147980
689,2022-12,인도네시아,아시아,1356,18899,20255
690,2022-12,일본,아시아,240362,1126845,1367207
691,2022-12,카타르,아시아,89,2662,2751
692,2022-12,태국,아시아,19546,128377,147923
693,2022-12,필리핀,아시아,9611,46162,55773
694,2023-01,대만,아시아,38106,219072,257178
695,2023-01,말레이시아,아시아,134,4189,4323
696,2023-01,미국,오세아니아,4612,24269,28881
697,2023-01,베트남,아시아,32337,241300,273637
698,2023-01,싱가포르,아시아,25702,206081,231783
699,2023-01,아랍에미리트,아시아,566,25971,26537
700,2023-01,인도네시아,아시아,4181,39847,44028
701,2023-01,일본,아시아,220407,1107776,1328183
702,2023-01,중국,아시아,563,3108,3671
703,2023-01,태국,아시아,31399,202354,233753
704,2023-01,터키,유럽,110,3287,3397
705,2023-01,필리핀,아시아,11155,51608,62763
706,2023-02,대만,아시아,37784,195286,233070
707,2023-02,몰타,유럽,79,4803,4882
708,2023-02,미국,오세아니아,3392,13610,17002
709,2023-02,베트남,아시아,22549,148407,170956
710,2023-02,싱가포르,아시아,22690,150521,173211
711,2023-02,인도네시아,아시아,11704,91133,102837
712,2023-02,일본,아시아,157729,711403,869132
713,2023-02,중국,아시아,6813,37791,44604
714,2023-02,태국,아시아,18000,116290,134290
715,2023-02,터키,유럽,2768,19477,22245
716,2023-02,필리핀,아시아,8952,51466,60418
717,2023-03,그리스,유럽,0,15,15
718,2023-03,대만,아시아,37742,178894,216636
719,2023-03,라오스,아시아,961,27556,28517
720,2023-03,미국,오세아니아,3064,12059,15123
721,2023-03,베트남,아시아,22441,156585,179026
722,2023-03,스페인,유럽,6622,62100,68722
723,2023-03,싱가포르,아시아,19188,129237,148425
724,2023-03,요르단,아시아,0,27,27
725,2023-03,인도네시아,아시아,3725,38939,42664
726,2023-03,일본,아시아,138519,572674,711193
727,2023-03,중국,아시아,4377,21306,25683
728,2023-03,태국,아시아,16214,100457,116671
729,2023-03,필리핀,아시아,18135,85790,103925
730,2023-04,대만,아시아,35545,183452,218997
731,2023-04,라오스,아시아,148,4767,4915
732,2023-04,미국,아메리카,340,7327,7667
733,2023-04,미국,오세아니아,10131,38059,48190
734,2023-04,베트남,아시아,23611,153616,177227
735,2023-04,스페인,유럽,467,3440,3907
736,2023-04,싱가포르,아시아,18517,127571,146088
737,2023-04,인도네시아,아시아,606,7136,7742
738,2023-04,일본,아시아,149430,662575,812005
739,2023-04,중국,아시아,1765,15914,17679
740,2023-04,태국,아시아,20401,114994,135395
741,2023-04,필리핀,아시아,17032,86010,103042
742,2023-05,대만,아시아,34682,168914,203596
743,2023-05,몽골,아시아,13447,127530,140977
744,2023-05,미국,아메리카,154,3540,3694
745,2023-05,미국,오세아니아,6035,20668,26703
746,2023-05,베트남,아시아,21657,142188,163845
747,2023-05,싱가포르,아시아,20573,134903,155476
748,2023-05,아랍에미리트,아시아,125,5482,5607
749,2023-05,인도네시아,아시아,760,2909,3669
750,2023-05,일본,아시아,151002,669494,820496
751,2023-05,중국,아시아,9831,56334,66165
752,2023-05,태국,아시아,14906,88483,103389
753,2023-05,필리핀,아시아,20867,103369,124236
754,2023-06,대만,아시아,35982,155477,191459
755,2023-06,몽골,아시아,3286,19043,22329
756,2023-06,베트남,아시아,26561,147859,174420
757,2023-06,싱가포르,아시아,23444,128883,152327
758,2023-06,인도네시아,아시아,14066,78913,92979
759,2023-06,일본,아시아,181119,699006,880125
760,2023-06,조지아,유럽,90,5820,5910
761,2023-06,중국,아시아,4544,18566,23110
762,2023-06,캄보디아,아시아,441,5713,6154
763,2023-06,태국,아시아,14674,76209,90883
764,2023-06,필리핀,아시아,24682,104315,128997
765,2023-07,대만,아시아,38507,167271,205778
766,2023-07,말레이시아,아시아,177,3781,3958
767,2023-07,몽골,아시아,2444,12078,14522
768,2023-07,베트남,아시아,25792,145473,171265
769,2023-07,싱가포르,아시아,21605,122736,144341
770,2023-07,인도네시아,아시아,12483,72164,84647
771,2023-07,일본,아시아,184563,683017,867580
772,2023-07,중국,아시아,406,3789,4195
773,2023-07,태국,아시아,26752,135938,162690
774,2023-07,필리핀,아시아,21190,90245,111435
775,2023-08,대만,아시아,40870,172515,213385
776,2023-08,몰타,유럽,78,3794,3872
777,2023-08,몽골,아시아,8988,57491,66479
778,2023-08,베트남,아시아,24012,131458,155470
779,2023-08,싱가포르,아시아,20500,117497,137997
780,2023-08,인도네시아,아시아,4853,39545,44398
781,2023-08,일본,아시아,165885,602302,768187
782,2023-08,중국,아시아,6970,25475,32445
783,2023-08,태국,아시아,19450,96925,116375
784,2023-08,필리핀,아시아,19462,81579,101041
785,2023-09,대만,아시아,35810,159353,195163
786,2023-09,몽골,아시아,1958,12927,14885
787,2023-09,베트남,아시아,17830,109025,126855
788,2023-09,싱가포르,아시아,14086,92688,106774
789,2023-09,일본,아시아,126846,498311,625157
790,2023-09,조지아,유럽,55,3451,3506
791,2023-09,중국,아시아,19070,88601,107671
792,2023-09,태국,아시아,12981,78925,91906
793,2023-09,필리핀,아시아,7469,31376,38845
794,2023-10,대만,아시아,41024,183851,224875
795,2023-10,라오스,아시아,170,4647,4817
796,2023-10,베트남,아시아,22133,129137,151270
797,2023-10,싱가포르,아시아,15256,104011,119267
798,2023-10,이스라엘,아시아,731,6804,7535
799,2023-10,일본,아시아,158774,636680,795454
800,2023-10,중국,아시아,18706,90646,109352
801,2023-10,태국,아시아,12753,68474,81227
802,2023-10,필리핀,아시아,1446,4694,6140
803,2023-11,대만,아시아,43567,183248,226815
804,2023-11,라오스,아시아,266,7370,7636
805,2023-11,베트남,아시아,23447,131116,154563
806,2023-11,싱가포르,아시아,15298,100450,115748
807,2023-11,이집트,아프리카,2351,52039,54390
808,2023-11,일본,아시아,203829,778435,982264
809,2023-11,중국,아시아,24052,97663,121715
810,2023-11,태국,아시아,8531,42424,50955
811,2023-11,필리핀,아시아,3981,14336,18317
812,2023-12,대만,아시아,46055,264276,310331
813,2023-12,베트남,아시아,22737,150519,173256
814,2023-12,싱가포르,아시아,15017,109564,124581
815,2023-12,인도네시아,아시아,420,6848,7268
816,2023-12,일본,아시아,167053,752549,919602
817,2023-12,중국,아시아,25034,123296,148330
818,2023-12,태국,아시아,14467,95940,110407
819,2023-12,필리핀,아시아,9234,44900,54134
820,2024-01,대만,아시아,315288,305430,620718
821,2024-01,라오스,아시아,22886,22930,45816
822,2024-01,말레이시아,아시아,4903,4916,9819
823,2024-01,미국,오세아니아,8065,10277,18342
824,2024-01,베트남,아시아,192678,188581,381259
825,2024-01,싱가포르,아시아,159975,154855,314830
826,2024-01,요르단,아시아,3423,3406,6829
827,2024-01,일본,아시아,890450,866022,1756472
828,2024-01,조지아,유럽,4268,518,4786
829,2024-01,중국,아시아,187749,181810,369559
830,2024-01,태국,아시아,127073,125827,252900
831,2024-01,필리핀,아시아,88381,85453,173834
832,2024-02,대만,아시아,228586,206649,435235
833,2024-02,몽골,아시아,10748,6176,16924
834,2024-02,베트남,아시아,151923,135576,287499
835,2024-02,싱가포르,아시아,130430,114853,245283
836,2024-02,인도네시아,아시아,15739,11683,27422
837,2024-02,일본,아시아,711298,644820,1356118
838,2024-02,중국,아시아,122296,110837,233133
839,2024-02,쿠바,아메리카,3872,3829,7701
840,2024-02,태국,아시아,114475,100203,214678
841,2024-02,필리핀,아시아,74967,72430,147397
842,2024-03,대만,아시아,342884,76497,419381
843,2024-03,베트남,아시아,254149,40868,295017
844,2024-03,싱가포르,아시아,346766,41809,388575
845,2024-03,인도네시아,아시아,53402,4564,57966
846,2024-03,일본,아시아,1030047,257672,1287719
847,2024-03,중국,아시아,184311,43205,227516
848,2024-03,태국,아시아,186796,32886,219682
849,2024-03,필리핀,아시아,131852,33418,165270
850,2024-04,대만,아시아,295745,70414,366159
851,2024-04,말레이시아,아시아,2945,526,3471
852,2024-04,몽골,아시아,96934,22695,119629
853,2024-04,베트남,아시아,217032,40334,257366
854,2024-04,싱가포르,아시아,196494,35723,232217
855,2024-04,인도네시아,아시아,45349,9552,54901
856,2024-04,일본,아시아,930138,247088,1177226
857,2024-04,중국,아시아,158600,41430,200030
858,2024-04,태국,아시아,138654,29002,167656
859,2024-04,포르투갈,유럽,18967,591,19558
860,2024-04,필리핀,아시아,19417,5972,25389
861,2024-05,대만,아시아,258990,60977,319967
862,2024-05,몽골,아시아,183736,43035,226771
863,2024-05,베트남,아시아,236629,40142,276771
864,2024-05,싱가포르,아시아,232812,38427,271239
865,2024-05,인도네시아,아시아,134391,28839,163230
866,2024-05,일본,아시아,1191972,284869,1476841
867,2024-05,중국,아시아,62752,14423,77175
868,2024-05,태국,아시아,52509,8964,61473
869,2024-05,포르투갈,유럽,9111,443,9554
870,2024-05,필리핀,아시아,66669,19341,86010
871,2024-06,대만,아시아,239928,55012,294940
872,2024-06,몽골,아시아,221157,45953,267110
873,2024-06,베트남,아시아,228248,38559,266807
874,2024-06,싱가포르,아시아,236886,38170,275056
875,2024-06,인도네시아,아시아,144635,31491,176126
876,2024-06,일본,아시아,1110401,253775,1364176
877,2024-06,중국,아시아,70069,9683,79752
878,2024-06,태국,아시아,33263,4875,38138
879,2024-06,필리핀,아시아,73400,19650,93050
880,2024-07,대만,아시아,280505,71484,351989
881,2024-07,라오스,아시아,7876,862,8738
882,2024-07,몽골,아시아,221236,51645,272881
883,2024-07,베트남,아시아,274554,50101,324655
884,2024-07,싱가포르,아시아,235516,41258,276774
885,2024-07,인도네시아,아시아,165183,34538,199721
886,2024-07,일본,아시아,1256664,323289,1579953
887,2024-07,조지아,유럽,9061,229,9290
888,2024-07,중국,아시아,141443,40815,182258
889,2024-07,태국,아시아,21585,3256,24841
890,2024-07,필리핀,아시아,12720,3698,16418
891,2024-08,대만,아시아,327108,79787,406895
892,2024-08,몽골,아시아,204323,43794,248117
893,2024-08,베트남,아시아,258277,44989,303266
894,2024-08,싱가포르,아시아,229446,38951,268397
895,2024-08,인도네시아,아시아,88191,13892,102083
896,2024-08,일본,아시아,1120973,246339,1367312
897,2024-08,중국,아시아,189912,46280,236192
898,2024-08,태국,아시아,114267,21086,135353
899,2024-08,필리핀,아시아,15651,2928,18579
900,2024-09,대만,아시아,324908,76589,401497
901,2024-09,몽골,아시아,77654,13704,91358
902,2024-09,베트남,아시아,239487,38380,277867
903,2024-09,싱가포르,아시아,181063,29040,210103
904,2024-09,인도네시아,아시아,64640,12516,77156
905,2024-09,일본,아시아,924634,228772,1153406
906,2024-09,중국,아시아,213295,47333,260628
907,2024-09,태국,아시아,172404,28210,200614
908,2024-10,대만,아시아,396063,90224,486287
909,2024-10,베트남,아시아,221585,40700,262285
910,2024-10,싱가포르,아시아,179141,31118,210259
911,2024-10,이탈리아,유럽,17146,2405,19551
912,2024-10,인도네시아,아시아,108784,23942,132726
913,2024-10,일본,아시아,1228250,313624,1541874
914,2024-10,중국,아시아,242291,56819,299110
915,2024-10,태국,아시아,26386,5124,31510
916,2024-11,대만,아시아,248586,51267,299853
917,2024-11,베트남,아시아,152211,25584,177795
918,2024-11,싱가포르,아시아,103708,17554,121262
919,2024-11,이탈리아,유럽,4909,799,5708
920,2024-11,인도네시아,아시아,29400,7622,37022
921,2024-11,일본,아시아,775517,192186,967703
922,2024-11,중국,아시아,175854,39599,215453
923,2024-11,태국,아시아,20580,3507,24087
924,2024-12,대만,아시아,275889,54451,330340
925,2024-12,말레이시아,아시아,3465,143,3608
926,2024-12,미국,오세아니아,931,367,1298
927,2024-12,베트남,아시아,206537,33399,239936
928,2024-12,싱가포르,아시아,121822,19464,141286
929,2024-12,인도네시아,아시아,9982,1653,11635
930,2024-12,일본,아시아,884630,206161,1090791
931,2024-12,중국,아시아,186568,37543,224111
932,2024-12,태국,아시아,128469,20027,148496
933,2024-12,프랑스,유럽,7,50,57
934,2024-12,필리핀,아시아,1317,394,1711
935,2025-01,네팔,아시아,0,0,0
936,2025-01,대만,아시아,171280,32033,203313
937,2025-01,미국,아메리카,0,0,0
938,2025-01,미국,오세아니아,0,0,0
939,2025-01,베트남,아시아,120676,17829,138505
940,2025-01,싱가포르,아시아,97187,14913,112100
941,2025-01,인도,아시아,0,0,0
942,2025-01,인도네시아,아시아,61428,10697,72125
943,2025-01,일본,아시아,542474,117978,660452
944,2025-01,중국,아시아,139077,25830,164907
945,2025-01,태국,아시아,56802,9104,65906
946,2025-01,프랑스,유럽,0,0,0
947,2025-02,대만,아시아,66605,14263,80868
948,2025-02,베트남,아시아,42147,6941,49088
949,2025-02,싱가포르,아시아,37152,6306,43458
950,2025-02,이집트,아프리카,2900,124,3024
951,2025-02,인도네시아,아시아,26117,5562,31679
952,2025-02,일본,아시아,182382,42400,224782
953,2025-02,중국,아시아,42442,10367,52809
954,2025-02,태국,아시아,20660,3862,24522
955,2025-02,호주,오세아니아,2528,182,2710
